11111111
111E1P11
10C001C1
11111111