11111111
111E0P11
10C00111
11111111