11111111
1CCE1PC1
10000001
11111111