11111111
100E0P01
10C00001
10000001
1C0000C1
11111111