11111111
111E1P11
10000001
11111111