1111111111111
100000P0000E1
1CCCCCC000001
1111111111111
