11111
10001
1EPC1
10001
11111
