111111111111111111111111111111111111111111111111111111111
100E0P000000000000000000000000000000000000000000000000001
10C000000000000000000000000000000000000000000000000000001
100000000000000000000000000000000000000000000000000000001
1C0000C00000000000000000000000000000000000000000000000001
1C0000C00000000000000000000000000000000000000000000000001
1C0000C00000000000000000000000000000000000000000000000001
1C0000C00000000000000000000000000000000000000000000000001
1C0000C00000000000000000000000000000000000000000000000001
1C0000C00000000000000000000000000000000000000000000000001
1C0000C00000000000000000000000000000000000000000000000001
1C0000C00000000000000000000000000000000000000000000000001
1C0000C00000000000000000000000000000000000000000000000001
100000000000000000000000000000000000000000000000000000001
100000000000000000000000000000000000000000000000000000001
100000000000000000000000000000000000000000000000000000001
100000000000000000000000000000000000000000000000000000001
100000000000000000000000000000000000000000000000000000001
100000000000000000000000000000000000000000000000000000001
100000000000000000000000000000000000000000000000000000001
100000000000000000000000000000000000000000000000000000001
100000000000000000000000000000000000000000000000000000001
100000000000000000000000000000000000000000000000000000001
100000000000000000000000000000000000000000000000000000001
100000000000000000000000000000000000000000000000000000001
100000000000000000000000000000000000000000000000000000001
100000000000000000000000000000000000000000000000000000001
100000000000000000000000000000000000000000000000000000001
100000000000000000000000000000000000000000000000000000001
100000000000000000000000000000000000000000000000000000001
100000000000000000000000000000000000000000000000000000001
111111111111111111111111111111111111111111111111111111111