111111111111111111111111111111111111111111111111111111111
11111110000000000001111111CCCCCCCCC1111111100000000000001
1CCC00000000000000000000000000000000000000000000000000001
1111111111111111111111CCCCP000000000000000000000000000001
111110000000000000000000000000000000000000000000000000001
100000000000000000000000000000000000000000000000000000001
111110000000000000000000000000000000000000000000000000001
100000000000000000000000000000000000000000000000000000001
100000000000000000000000CCCC000000CC000C00000000000001111
100000000000000000000000000000000000000000000000000001111
100000000000000000000000000000000000000000000000000001111
11111000000000000000000000000000000000000000000CCCCC11111
100000000000000000000000000000000000000000000000000000001
111110000000000000000000000000000000000000000000000000001
100000000000000000000000000000000000000000000000000111111
111111CCCCCCC000000000000000000000000000000000000000000E1
111111111111111111111111111111111111111111111111111111111